-1 -1 -1 -1 -1 -1 -1 -1 -1 -1 -1
-1 -1 -1 -1 -1 -1 -1 -1 -1 25 -1
-1 -1 -1 -1 -1 -1 -1 -1 -1 0 -1
-1 35 -1 -1 -1 -1 -1 26 27 28 -1
-1 36 5 4 3 2 1 29 30 31 -1
-1 -1 6 -1 -1 22 -1 32 33 34 -1 
-1 -1 7 -1 42 43 -1 -1 21 -1 -1
-1 -1 8 -1 44 45 -1 -1 20 40 -1
-1 -1 9 38 -1 23 -1 -1 19 41 -1
-1 37 10 -1 46 24 -1 -1 18 -1 -1
-1 -1 11 12 13 14 15 16 17 -1 -1
-1 -1 -1 39-1 -1 -1 -1 -1 -1 -1
-1 -1 -1 -1 -1 -1 -1 -1 -1 -1 -1