-1 -1 -1 -1 -1 -1 -1 -1 -1 -1 -1
-1 -1 -1 -1 -1 -1 -1 -1 -1 1 -1
-1 -1 -1 -1 -1 -1 -1 -1 -1 0 -1
-1 3 -1 -1 -1 -1 -1 2 2 2 -1
-1 3 0 0 0 0 0 2 2 2 -1
-1 -1 0 -1 -1 0 -1 2 2 2 -1 
-1 -1 0 -1 8 8 -1 -1 0 -1 -1
-1 -1 0 -1 8 8 -1 -1 0 7 -1
-1 -1 0 5 -1 0 -1 -1 0 7 -1
-1 4 0 -1 9 0 -1 -1 0 -1 -1
-1 -1 0 0 0 0 0 0 0 -1 -1
-1 -1 -1 6 -1 -1 -1 -1 -1 -1 -1
-1 -1 -1 -1 -1 -1 -1 -1 -1 -1 -1