-1 -1 -1 -1 -1 -1 -1 -1 -1 -1 -1
-1 -1 -1 -1 -1 -1 -1 -1 -1 1 -1
-1 -1 -1 -1 -1 -1 -1 -1 -1 0 -1
-1 12 -1 -1 -1 -1 -1 2 3 4 -1
-1 11 0 0 0 0 0 5 6 7 -1
-1 -1 0 -1 -1 0 -1 8 9 10 -1 
-1 -1 0 -1 18 19 -1 -1 0 -1 -1
-1 -1 0 -1 20 21 -1 -1 0 16 -1
-1 -1 0 14 -1 0 -1 -1 0 17 -1
-1 13 0 -1 22 0 -1 -1 0 -1 -1
-1 -1 0 0 0 0 0 0 0 -1 -1
-1 -1 -1 15 -1 -1 -1 -1 -1 -1 -1
-1 -1 -1 -1 -1 -1 -1 -1 -1 -1 -1